###########
#.X..#....#
#.####....#
#.X..###.##
#.OX*#XX.##
#..X.#....#
###########

